

R 1920 1080


NO textures/brick.xpm


SO textures/brick.xpm

EA textures/brick.xpm
WE textures/brick.xpm

S textures/brick.xpm

C 254,36,98


F 7,32,1540



111111
101221111
1221100101
12211N011
1111111111111111111
