R 1000 1000
NO textures/brick.xpm
SO textures/colorstone.xpm
EA textures/stone.xpm
WE textures/wood.xpm

S textures/trump.xpm

C 254,36,98
F 7,32,154



11111111111111111111111111
12000000000111000000000001
10000000000000000222200001
10000000000000000222200001
100000000000100E0222200001
11000000000101000000000011
10000000000010000000000001
10000000000000000000000001
10000000000000000000000001
12000000000010000000000021
11111111111111111111111111
