R 1920 1080
NO textures/brick.xpm
SO textures/brick.xpm
EA textures/brick.xpm
WE textures/brick.xpm

S textures/brick.xpm

C 254,36,98
F 7,32,154



111111
1012211110
10211000101
002110N011
1111111111111111111
