R 801 400
NO textures/bonus/wall1_64.xpm
SO textures/bonus/wall2_64.xpm
WE textures/bonus/wall3_64.xpm
EA textures/bonus/wall4_64.xpm
S textures/bonus/patrick1.xpm
S2 textures/bonus/sponge2.xpm
S3 textures/bonus/jelly.xpm
CT textures/bonus/sky.xpm
FT textures/bonus/floor64.xpm
F 184, 113, 39
C 51, 198, 227

        1111111111111111111111111
        1000000000110000000000401
        1011000001110000002003001
        1021004000000000000000001
111111111011000001110000000000001
130000000011000001111111111111111
11110111111111011100000020001
11110111111111011101010110001
11000000110101011100100010001
100020000S0000001101210010201
10000030000020000001010010001
11000002040000000000000030401
10000000000000300000000000001
11111111111111111111111111111
