R 801 400
NO textures/wall_n.xpm
SO textures/wall_s.xpm
WE textures/wall_w.xpm
EA textures/wall_e.xpm
S textures/pillar.xpm
S2 textures/barrel.xpm
CT textures/eagle.xpm
FT textures/wood.xpm
F 184, 113, 39
C 51, 198, 227

        1111111111111111111111111
        1000000000110000000003001
        1011000001110000002000001
        1001000000000000000000001
111111111011000001110000000000001
100000000011000001111111111111111
11110111111111011100000000001
11110111111111011101010010201
11000000110101011100000010001
100020000E0000001100000010201
10000030000030000001010010001
1100000111010101111101111000111
11110111 1110101 101111010001
11111111 1111111 111111111111
